19 13 12 D
  XXXXXXXXXXXXXXXXX
XXXMXXXXXXXXXXXXXXX
XDDDDXGGGGXXXXXXXXX
XDJ.DXGGGGXXXXXXXXX
XDJJDXGGGGXXXXXXXXX
XX.JDXXXJXXXXXXXXXX
 X.XXXD.JDX        
XX...J..JDX        
XD.J.X..JDX        
XDJ..X...DX        
XD.J.X...DX        
XDDDDXDDDDX        
XXXXXXXXXXX        