19 13 12 D
  XXXXXXXXXXXXXXXXX
XXXMXXXXXXXXXXXGGGX
XDDDDXXXXXXXXXXGGGX
XDJ.DXXD.......GGGX
XDJJDXXD.XXXXXXGGGX
XX.JDXXXJXXXXXXXXXX
 X.XXXD.JDX        
XX...J..JDX        
XD.J.X..JDX        
XDJ..X...DX        
XD.J.X...DX        
XDDDDXDDDDX        
XXXXXXXXXXX        