7 5 1 R
XXXXXXX
X.XG..X
X.J...X
XM.X..X
XXXXXXX