10 09 04 U
     XXXXX
XXXXXXDDDX
XD.J....DX
XD.JXXX.XX
XXGJG.G.GX
 X.JXDDDDX
 X.MXXXXXX
 XDDX     
 XXXX     