10 09 04 U
     XXXXX
XXXXXXDDDX
XD.G....DX
XD.GXXX.XX
XXJGJ.J.JX
 XMGXDDDDX
 X..XXXXXX
 XDDX     
 XXXX     